




111111111111111111111
1000000000000000000C1
1000C1000000100000001
111111111111111110011
1000C1000000100000001
10000000P000000EC0001
111111111111111111111





