




111111111
100000001
1000EP001
100C00001
100000001
100000001
100000001
100001111
111100001
111111111
