




111111111111111111
1000001000000000P1
101C10100010001111
101110100010001CC1
10000000E010000CC1
111111111111111111
