




1111111111111111111111111111111111111111111111111
1000000000000000P00000000010000000000000000110001
1000001000100011111111100010000E10000100000110C01
100000100010001000000010C010C00111111111111110C01
10000010E010001000C000111110000100000000000110001
100000111110001111000000000000010000CCC0000111011
1000000000100000000001111111000100000000000000001
1000001111100011111111111111000000000000000000001
1000000000000011111111111111111111111000011111111
1000001111111111111111111111111111111000011111111
1000000000000000000000000000000000000000011111111
1111111111111111111111111111111111111111111111111
