


1111111
100C001
1000C01
1C0E001
100C0P1
1111111
