





111111111111
10C000E00C01
100111111001
1C0000100C01
100C000000P1
111111111111

